18 25
#R#######################
#  #         #       #  #
## # #######   ## ##    #
#                       #
#    ### ###   ## ##    #
#    #     #            #
#    #     # #       #  #
#    #     #            #
########## # # # # # # ##
#                       #
# # # # # # # # # # # # #
#                       #
## # # # # # # # # # # ##
#    #    #    #        #
#         #    #   #    #
#    #         #   #    #
#    #    #        #    A
#########################